###########################################
#                                         #
#1                                        #
#######################  ##################
#         ##                            ###
#  ######    ################  ########   #
#  ############               #        #  #
#  #   #   #  #               # # #  # #  #
#    #   #   ##               # # #### #  #
###############               # #      #  #
#                             # ###  ###  #
# #################################  ###  #
#                                         #
###########################################
